x=  4 y=  1 z=  1
x=  5 y=  1 z=  1
x=  6 y=  1 z=  1
x=  3 y=  2 z=  1
x=  4 y=  2 z=  2
x=  5 y=  2 z=  8
x=  6 y=  2 z=  2
x=  7 y=  2 z=  1
x=  2 y=  3 z=  1
x=  3 y=  3 z=  #
x=  4 y=  3 z=  3
x=  5 y=  3 z=  3

x=  2 y=  5 z=  2
x=  3 y=  5 z=  3
x=  4 y=  5 z=  4
x=  5 y=  5 z=  5
x=  6 y=  5 z=  4
x=  7 y=  5 z=  3
x=  8 y=  5 z=  2
x=  9 y=  5 z=  1
x=  1 y=  6 z=  1
x=  2 y=  6 z=  2
x=  3 y=  6 z=  3
x=  4 y=  6 z=  4
x=  5 y=  6 z=  4
x=  6 y=  6 z=  4
x=  7 y=  6 z=  3
x=  8 y=  6 z=  2
x=  9 y=  6 z=  1
x=  2 y=  7 z=  1
x=  3 y=  7 z=  2
x=  4 y=  7 z=  3
x=  5 y=  7 z=  3
x=  6 y=  7 z=  3
x=  7 y=  7 z=  2
x=  8 y=  7 z=  1
x=  3 y=  8 z=  1
x=  4 y=  8 z=  2
x=  5 y=  8 z=  2
x=  6 y=  8 z=  2
x=  7 y=  8 z=  1
x=  4 y=  9 z=  1
x=  5 y=  9 z=  1
x=  6 y=  9 z=  1
